111111111111111111111111111111111111111111
1E0000000000000000000000000000000000000001
112222222222222222222222222222222222222221
100000000000000000000000000000000000000001
100000020000200020020002000200020020000001
100000000000000000000000000000000000000001
100000020000200020020002000200020020000001
100000000000000000000000000000000000000001
100000020000200020020002000200020020000001
100000000000000000000000000000000000000001
100000020000200020020002000200020020000001
100000000000000000000000000000000000000001
100000020000200020020002000200020020000001
100000000000000000000000000000000000000001
100000020000200020020002000200020020000001
100000000000000000000Z00000000000000000001
111111111111111111111111111111111111111111
