 NO ./pics/walls/wall_04.xpm

SO       ./pics/walls/wall_06.xpm
WE ./pics/walls/wall_07.xpm

EA ./pics/walls/wall_14.xpm

F 80,80,80 
C     85,183,208
  
11111111111111111111111
10000000000000000000001
10111111111111111111101111111111111111111111111111111111111
101                 1000000000000000000000000000000000000001
101   11111111     11011111111111111111111111111111111111001
101   100000011111111001                                1001
101  11001000000000000011111111                         1001
101  100000001111110000000000011                        1001
1011110000000000000000111100000111111111                1001
1000000000010000000000000000000000000001                1001
11111111100000000N0000011110000111111101                1001
        1000000000000001  111111     101                1001
        1111111111110111             101                1001
                   101111111111111111101                1001
                   100000000000000000001                1001
                   111111111110011111111                1001
                             1001                       1001
                             1001                       1001
                             1001                       1001
                             1001111111111111111111111111001
                             1000000000000000000000000000001
                             1000000000000000000000000000001
                             1111111111111111111111111111111
                             